#@##@##@#@##########
#***********###@##@#
@******************@
##@##**************#
####@**************@
##@##**************#
#******************#
@*************###@##
#*************@#####
##@##@#@#@##@#######